Qt5DBus                          Qt5 DBus - Qt DBus module
sqlite3                          SQLite - SQL database engine
gtk-doc                          gtk-doc - API documentation generator
python-3.4m                      Python - Python library
pixman-1                         Pixman - The pixman library (version 1)
iso-codes                        iso-codes - ISO country, language, script and currency codes and translations
Qt5PlatformSupport               Qt5 PlatformSupport - Qt PlatformSupport module
gmodule-export-2.0               GModule - Dynamic module loader for GLib
cucul                            caca - Colour ASCII-Art library
xaw7                             Xaw - X Athena Widgets Library, version 7
cairo-svg                        cairo-svg - SVG surface backend for cairo graphics library
libdrm_intel                     libdrm_intel - Userspace interface to intel kernel DRM services
nettle                           Nettle - Nettle low-level cryptographic library (symmetric algorithms)
gnutls                           GnuTLS - Transport Security Layer implementation for the GNU system
OGRE-RTShaderSystem              OGRE-RTShaderSystem - Real time shader generation component for OGRE
OGRE-Paging                      OGRE-Paging - General purpose paging component for OGRE
fribidi                          GNU FriBidi - Unicode Bidirectional Algorithm Library
libpcreposix                     libpcreposix - PCREPosix - Posix compatible interface to libpcre
cairo-tee                        cairo-tee - tee surface backend for cairo graphics library
dri                              dri - Direct Rendering Infrastructure
dbus-1                           dbus - Free desktop message bus
zzip-zlib-config                 zzip-zlib-config - ZLib Config (for ZZipLib)
xcb-render                       XCB Render - XCB Render Extension
mobile-broadband-provider-info   mobile-broadband-provider-info - Mobile Broadband Service Provider Information Database
xkbcommon                        xkbcommon - XKB API common to servers and clients
gnome-icon-theme-symbolic        gnome-icon-theme-symbolic - A collection of symbolic icons used as the basis for GNOME themes
udisks                           udisks - udisks storage daemon
cairo-png                        cairo-png - PNG functions for cairo graphics library
wayland-cursor                   Wayland Cursor - Wayland cursor helper library
curlpp                           curlpp - cURLpp is a libcurl C++ wrapper
libcurl                          libcurl - Library to transfer files with ftp, http, etc.
pangoxft                         Pango Xft - Xft font support for Pango
ao                               ao - ao is a cross-platform audio output library
xcursor                          Xcursor - X Cursor Library
libmodplug                       libmodplug - The ModPlug mod file playing library.
xft                              Xft - X FreeType library
libidn                           Libidn - IETF stringprep, nameprep, punycode, IDNA text processing.
zzipmmapped                      zzipmmapped - ZZipLib - libZ-based ZIP-access Library with an Easy-to-Use API
libva-drm                        libva-drm - Userspace Video Acceleration (VA) drm interface
glu                              glu - Mesa OpenGL Utility library
kdb                              kdb - Kerberos database access libraries
libxslt                          libxslt - XSLT library version 2.
xtrans                           XTrans - Abstract network code for X
libexif                          libexif - Library for easy access to EXIF data
gdk-pixbuf-2.0                   GdkPixbuf - Image loading and scaling
xf86vidmodeproto                 XF86VidModeProto - XF86VidMode extension headers
Qt5QuickParticles                Qt5 QuickParticles - Qt QuickParticles module
samplerate                       samplerate - An audio Sample Rate Conversion library
xbuild12                         XBuild 12.0 - XBuild/MSBuild 12.0
caca                             caca - Colour ASCII-Art library
MagickCore-6.Q16                 MagickCore - MagickCore - C API for ImageMagick (ABI Q16)
libcdio                          libcdio - Portable CD-ROM I/O library
damageproto                      DamageProto - Damage extension headers
OGRE-Overlay                     OGRE-Overlay - Overlay component for OGRE
libpulse                         libpulse - PulseAudio Client Interface
Qt5Sql                           Qt5 Sql - Qt Sql module
enca                             Enca - Extermely Naive Charset Analyser library
libva-glx                        libva-glx - Userspace Video Acceleration (VA) glx interface
expat                            expat - expat XML parser
mate-default-applications        mate-default-applications - Default MATE applications configuration
cairo-xlib                       cairo-xlib - Xlib surface backend for cairo graphics library
mit-krb5-gssapi                  mit-krb5-gssapi - Kerberos implementation of the GSSAPI
videoproto                       VideoProto - Video extension headers
libavformat                      libavformat - FFmpeg container format library
banshee-lastfm-gui               Banshee Last.fm GUI - Last.fm GUI libraries for the Banshee Media Framework
Qt5QmlDevTools                   Qt5 QmlDevTools - Qt QmlDevTools module
krb5                             krb5 - An implementation of Kerberos network authentication
bluez                            BlueZ - Bluetooth protocol stack for Linux
mono-options                     Mono.Options - Command Line Parsing Library
xcb-dri2                         XCB DRI2 - XCB DRI2 Extension
xcb-dri3                         XCB DRI3 - XCB DRI3 Extension
taglib                           TagLib - Audio meta-data library
mad                              mad - MPEG Audio Decoder
libva-tpi                        libva-tpi - Userspace Video Acceleration (VA) 3rd party interface
monodevelop                      MonoDevelop - Free .NET Development Environment
openal                           OpenAL - OpenAL is a cross-platform 3D audio API
Qt5QuickTest                     Qt5 QuickTest - Qt QuickTest module
xcb-image                        XCB Image library - XCB image convenience library
kbproto                          KBProto - KB extension headers
xrandr                           Xrandr - X RandR Library
Magick++                         Magick++ - Magick++ - C++ API for ImageMagick (ABI Q16)
tinyxml                          TinyXml - simple, small, C++ XML parser
bash-completion                  bash-completion - programmable completion for the bash shell
wayland-egl                      wayland-egl - Mesa wayland-egl library
fontutil                         FontUtil - Font utilities dirs
gdk-2.0                          GDK - GTK+ Drawing Kit (x11 target)
Qt5Quick                         Qt5 Quick - Qt Quick module
x264                             x264 - H.264 (MPEG4 AVC) encoder library
SDL_mixer                        SDL_mixer - mixer library for Simple DirectMedia Layer
xcomposite                       Xcomposite - X Composite Extension Library
libtasn1                         libtasn1 - Library for ASN.1 and DER manipulation
OGRE-Volume                      OGRE-Volume - Voxel based terrain component for OGRE
dri2proto                        DRI2Proto - DRI2 extension headers
sdl                              sdl - Simple DirectMedia Layer is a cross-platform multimedia library designed to provide low level access to audio, keyboard, mouse, joystick, 3D hardware via OpenGL, and 2D video framebuffer.
glew                             glew - The OpenGL Extension Wrangler library
sm                               SM - X Session Management Library
libgphoto2                       libgphoto2 - Library for easy access to digital cameras
monodevelop-core-addins          MonoDevelop Core Add-ins - MonoDevelop Core Add-ins
system.web.mvc                   System.Web.Mvc - System.Web.Mvc - ASP.NET MVC
cwiid                            CWiid - CWiid Wiimote Interface
geany                            Geany - A fast and lightweight IDE using GTK2
dotnet                           Standard libraries in a .NET setup - References all the standard .NET libraries for compilation
xorg-sgml-doctools               xorg-sgml-doctools - Stylesheets and entities for X.Org documentation
cairo-ps                         cairo-ps - PostScript surface backend for cairo graphics library
p11-kit-1                        p11-kit - Library and proxy module for properly loading and sharing PKCS
hexchat-plugin                   HexChat plugins - Header and path for HexChat plugins
Magick++-6.Q16                   Magick++ - Magick++ - C++ API for ImageMagick (ABI Q16)
OGRE-MeshLodGenerator            OGRE-MeshLodGenerator - Mesh Lod Generator for OGRE
scrnsaverproto                   ScrnSaverProto - ScrnSaver extension headers
python                           Python - Python library
OGRE                             OGRE - Object-Oriented Graphics Rendering Engine
protobuf-lite                    Protocol Buffers - Google's Data Interchange Format
gssrpc                           gssrpc - GSSAPI RPC implementation
libpulse-mainloop-glib           libpulse-mainloop-glib - PulseAudio GLib 2.0 Main Loop Wrapper
mirclient                        mirclient - Mir client library
gnome-icon-theme                 gnome-icon-theme - A collection of icons used as the basis for GNOME themes
slang                            slang - S-Lang programming library and interpreter
gdk-pixbuf-xlib-2.0              GdkPixbuf Xlib - GdkPixbuf rendering for Xlib
ImageMagick                      ImageMagick - ImageMagick - Convert, Edit, and Compose Images (ABI Q16)
python2                          Python - Python library
libavcodec                       libavcodec - FFmpeg codec library
libdrm_radeon                    libdrm_radeon - Userspace interface to kernel DRM services for radeon
gmodule-2.0                      GModule - Dynamic module loader for GLib
libdrm                           libdrm - Userspace interface to kernel DRM services
libdca                           libdca - A decoding library for DTS Coherent Acoustics streams.
libgdiplus                       libgdiplus - GDI+ implementation
libpulse-simple                  libpulse-simple - PulseAudio Simplified Synchronous Client Interface
libplist                         libplist - A library to handle Apple Property Lists whereas they are binary or XML
Wand-6.Q16                       MagickWand - MagickCore - C API for ImageMagick (ABI Q16)
pango                            Pango - Internationalized text handling
banshee-mono-media               Banshee Mono.Media - Mono.Media libraries for the Banshee Media Framework
reactive                         Reactive Extensions - Reactive Extensions
banshee-hyena                    Banshee Hyena - Hyena libraries for the Banshee Media Framework
fixesproto                       FixesProto - X Fixes extension headers
cucul++                          caca++ - Colour ASCII-Art library C++ bindings
ImageMagick++-6.Q16              ImageMagick++ - Magick++ - C++ API for ImageMagick (ABI Q16)
flac                             FLAC - Free Lossless Audio Codec Library
pangoft2                         Pango FT2 and Pango Fc - Freetype 2.0 and fontconfig font support for Pango
libavfilter                      libavfilter - FFmpeg audio/video filtering library
libslab                          libslab - Beautiful App Slab
libcec                           libcec - Pulse-Eight CEC adapter library
xineramaproto                    XineramaProto - Xinerama extension headers
sane-backends                    SANE Backends - Backends for SANE, the universal scanner interface
compositeproto                   CompositeExt - Composite extension headers
SDL2_image                       SDL2_image - image loading library for Simple DirectMedia Layer
Qt5PrintSupport                  Qt5 PrintSupport - Qt PrintSupport module
MagickWand-6.Q16                 MagickWand - MagickWand - C API for ImageMagick (ABI Q16)
aspnetwebstack                   AspNetWebStack - References Microsoft ASP.NET Web Stack
Qt5Test                          Qt5 Test - Qt Unit Testing Library
libpcre                          libpcre - PCRE - Perl compatible regular expressions C library with 8 bit character support
randrproto                       RandrProto - Randr extension headers
cairo-xcb-shm                    cairo-xcb-shm - XCB/SHM functions for cairo graphics library
zzipwrap                         zzipwrap - Callback Wrappers for ZZipLib
OIS                              OIS - Cross platform C++ Input Framework
glproto                          GLProto - GL extension headers
cairo-pdf                        cairo-pdf - PDF surface backend for cairo graphics library
pangocairo                       Pango Cairo - Cairo rendering support for Pango
libssh_threads                   libssh_threads - The SSH Library Thread Extension
krb5-gssapi                      krb5-gssapi - Kerberos implementation of the GSSAPI
libavdevice                      libavdevice - FFmpeg device handling library
Qt5Core                          Qt5 Core - Qt Core module
x11-xcb                          X11 XCB - X Library XCB interface
libdts                           libdts - Backward compatibility place-holder for libdca.
gthread-2.0                      GThread - Thread support for GLib
libusb-1.0                       libusbx-1.0 - C API for USB device access from Linux, Mac OS X, Windows and OpenBSD/NetBSD userspace
libssh                           libssh - The SSH Library
vdpau                            VDPAU - The Video Decode and Presentation API for UNIX
gnome-keyring-1                  gnome-keyring - The GNOME keyring libraries
intel-gen4asm                    intel-gen4asm - An assembler compiler for the Intel 965+ Chipset
libssl                           OpenSSL - Secure Sockets Layer and cryptography libraries
libpcrecpp                       libpcrecpp - PCRECPP - C++ wrapper for PCRE
cairo-xcb                        cairo-xcb - XCB surface backend for cairo graphics library
opusurl                          opusurl - High-level Opus decoding library, URL support
gl                               gl - Mesa OpenGL library
libcrypto                        OpenSSL-libcrypto - OpenSSL cryptography library
xcb-glx                          XCB GLX - XCB GLX Extension
mate-window-settings-2.0         mate-window-settings-2.0 - Utility library for getting window manager settings
xorg-wacom                       xorg-wacom - X.Org Wacom Tablet driver.
zzipfseeko                       zzipfseeko - ZZipLib - libZ-based ZIP-access Library with an Easy-to-Use API
MagickWand                       MagickWand - MagickWand - C API for ImageMagick (ABI Q16)
egl                              egl - Mesa EGL library
mit-krb5                         mit-krb5 - An implementation of Kerberos network authentication
libxml-2.0                       libXML - libXML library version2.
shared-desktop-ontologies        shared-desktop-ontologies - Common OSCAF desktop ontologies
libdrm_nouveau                   libdrm_nouveau - Userspace interface to nouveau kernel DRM services
alsa                             alsa - Advanced Linux Sound Architecture (ALSA) - Library
dotnet35                         Standard libraries in a .NET setup - References all the standard .NET libraries for compilation (.NET Framework 3.5 compatibility)
sndfile                          sndfile - A library for reading and writing audio files
cairo-gobject                    cairo-gobject - gobject functions for cairo graphics library
yelp-xsl                         yelp-xsl - Yelp XSLT Stylesheets
wayland-client                   Wayland Client - Wayland client side library
gmodule-no-export-2.0            GModule - Dynamic module loader for GLib
libv4l2rds                       libv4l2rds - v4l2 RDS decode library
xextproto                        XExtProto - XExt extension headers
SDL2_net                         SDL2_net - net library for Simple DirectMedia Layer
x11                              X11 - X Library
pm-utils                         pm-utils - Power management scripts for suspend and hibernate
system.web.extensions.design_1.0 System.Web.Extensions.Design - System.Web.Extensions.Design ASP.NET 2.0 add-on
libva-wayland                    libva-wayland - Userspace Video Acceleration (VA) wayland interface
libva-egl                        libva-egl - Userspace Video Acceleration (VA) egl interface
Qt5Bootstrap                     Qt5 Bootstrap - Qt Bootstrap module
libiso9660                       libiso9660 - ISO-9660 library of libcdio
xmu                              Xmu - Xmu Library
gtk+-unix-print-2.0              GTK+ - GTK+ Unix print support
hogweed                          Hogweed - Nettle low-level cryptographic library (public-key algorithms)
gnutls-extra                     GnuTLS-extra - Additional add-ons for GnuTLS licensed under GPL
mate-system-tools                gst - Mate System Tools
libmpeg2                         libmpeg2 - MPEG-1 and MPEG-2 stream decoding library
libexslt                         libexslt - EXSLT Extension library
wayland-server                   Wayland Server - Server side implementation of the Wayland protocol
libva-x11                        libva-x11 - Userspace Video Acceleration (VA) x11 interface
xi                               Xi - X Input Extension Library
banshee-services                 Banshee Services - Service layer APIs for the Banshee Media Framework
Qt5Xml                           Qt5 Xml - Qt Xml module
cecil                            Mono Internal -- Do not use. - Mono Internal Libraries -- Do not use
mate-icon-theme                  mate-icon-theme - A collection of icons used as the basis for MATE themes
mircommon                        mircommon - Mir common headers
libcupsfilters                   libcupsfilters - Library for reading and writing cups filters
libmpeg2convert                  libmpeg2convert - Image conversion library helper for libmpeg2
xt                               Xt - X Toolkit Library
cairo-fc                         cairo-fc - Fontconfig font backend for cairo graphics library
xv                               Xv - The Xv Library
glib-2.0                         GLib - C Utility Library
cairo                            cairo - Multi-platform 2D graphics library
Qt5Qml                           Qt5 Qml - Qt Qml module
xbitmaps                         X bitmaps - Bitmaps that are shared between X applications
Wand                             MagickWand - MagickCore - C API for ImageMagick (ABI Q16)
Qt5Network                       Qt5 Network - Qt Network module
unittest++                       unittest++ - unittest++ is a unit testing framework for C++
udev                             udev - udev
assimp                           Assimp - Import various well-known 3D model formats in an uniform manner.
cairo-ft                         cairo-ft - FreeType font backend for cairo graphics library
pygtksourceview-2.0              PyGtkSourceView - Python bindings for GtkSourceView
banshee-hyena-data-sqlite        Banshee Hyena - Hyena sqlite libraries for the Banshee Media Framework
glfw3                            GLFW - A multi-platform library for OpenGL, window and input
xcb-sync                         XCB Sync - XCB Sync Extension
gio-unix-2.0                     GIO unix specific APIs - unix specific headers for glib I/O library
MagickCore                       MagickCore - MagickCore - C API for ImageMagick (ABI Q16)
banshee-lastfm                   Banshee Last.fm - Last.fm libraries for the Banshee Media Framework
vorbisfile                       vorbisfile - vorbisfile is a library that provides a convenient high-level API for decoding and basic manipulation of all Vorbis I audio streams
libswresample                    libswresample - FFmpeg audio resampling library
glesv2                           glesv2 - Mesa OpenGL ES 2.0 library
system.web.mvc2                  System.Web.Mvc2 - System.Web.Mvc - ASP.NET MVC v2
xfixes                           Xfixes - X Fixes  Library
system.web.mvc3                  System.Web.Mvc3 - System.Web.Mvc - ASP.NET MVC v3
libv4lconvert                    libv4lconvert - v4l format conversion library
opus                             Opus - Opus IETF audio codec (floating-point build)
vorbisenc                        vorbisenc - vorbisenc is a library that provides a convenient API for setting up an encoding environment using libvorbis
kadm-client                      kadm-client - Kerberos administration client library
xcb-xfixes                       XCB XFixes - XCB XFixes Extension
librtmp                          librtmp - RTMP implementation
tomboy-addins                    Tomboy Addin Library - Library providing the interfaces for Tomboy addins
banshee-thickclient              Banshee ThickClient - GUI Service layer APIs for the Banshee Media Framework
monodoc                          Monodoc - Monodoc - Mono Documentation Tools
OGRE-Property                    OGRE-Property - General purpose property component for OGRE
xinerama                         Xinerama - The Xinerama Library
ImageMagick-6.Q16                ImageMagick - ImageMagick - Convert, Edit, and Compose Images (ABI Q16)
sdl2                             sdl2 - Simple DirectMedia Layer is a cross-platform multimedia library designed to provide low level access to audio, keyboard, mouse, joystick, 3D hardware via OpenGL, and 2D video framebuffer.
SDL2_mixer                       SDL2_mixer - mixer library for Simple DirectMedia Layer
libpng                           libpng - Loads and saves PNG files
usbutils                         usbutils - USB device database
libwebpdemux                     libwebpdemux - Library for parsing the WebP graphics format container
xpm                              Xpm - X Pixmap Library
libusb                           libusb - USB access library
wcf                              WCF - References WCF for compilation
Qt5Gui                           Qt5 Gui - Qt Gui module
gdk-x11-2.0                      GDK - GTK+ Drawing Kit (x11 target)
kadm-server                      kadm-server - Kerberos administration server library
mono-2                           Mono - Mono Runtime
Qt5X11Extras                     Qt5 X11Extras - Qt X11Extras module
xshmfence                        xshmfence - The X Shared Memory Fence Library
xcb-randr                        XCB RandR - XCB RandR Extension
libudev                          libudev - Library to access udev device information
nunit                            NUnit - Testing framework for CLI
freetype2                        FreeType 2 - A free, high-quality, and portable font engine.
xext                             Xext - Misc X Extension Library
cairo-script                     cairo-script - script surface backend for cairo graphics library
libtiff-4                        libtiff - Tag Image File Format (TIFF) library.
libpostproc                      libpostproc - FFmpeg postprocessing library
xau                              Xau - X authorization file management libary
harfbuzz                         harfbuzz - HarfBuzz text shaping library
xcb-present                      XCB Present - XCB Present Extension
ice                              ICE - X Inter Client Exchange Library
xdamage                          Xdamage - X Damage  Library
vorbis                           vorbis - vorbis is the primary Ogg Vorbis library
openssl                          OpenSSL - Secure Sockets Layer and cryptography libraries and tools
xxf86vm                          Xxf86vm - XFree86 Video Mode Extension Library
mate-keybindings                 mate-keybindings - Keybindings configuration for MATE applications
banshee-hyena-gui                Banshee Hyena GUI - Hyena GUI libraries for the Banshee Media Framework
libwebpmux                       libwebpmux - Library for manipulating the WebP graphics format container
gtk+-2.0                         GTK+ - GTK+ Graphical UI Library (x11 target)
atk                              Atk - Accessibility Toolkit
libgphoto2_port                  libgphoto2_port - Device-independent access to serial, USB, and other ports
banshee-musicbrainz              Banshee MusicBrainz - MusicBrainz libraries for the Banshee Media Framework
python-2.7                       Python - Python library
system.web.extensions_1.0        System.Web.Extensions - System.Web.Extensions ASP.NET 2.0 add-on
xkbcomp                          xkbcomp - XKB keymap compiler
libzip                           libzip - library for handling zip archives
wayland-scanner                  Wayland Scanner - Wayland scanner
libva                            libva - Userspace Video Acceleration (VA) core interface
xkeyboard-config                 XKeyboardConfig - X Keyboard configuration data
xcb-shape                        XCB Shape - XCB Shape Extension
mono-cairo                       Mono.Cairo - Cairo bindings for Mono
harfbuzz-icu                     harfbuzz - HarfBuzz text shaping library ICU integration
luajit                           LuaJIT - Just-in-time compiler for Lua
caca++                           caca++ - Colour ASCII-Art library C++ bindings
banshee-collection-indexer       Banshee Collection Indexer Helper - A library for applications to bundle to easily consume the Banshee Collection Indexer
pthread-stubs                    pthread stubs - Stubs missing from libc for standard pthread functions
xrender                          Xrender - X Render Library
xproto                           Xproto - Xproto headers
banshee-core                     Banshee Core - Core APIs for the Banshee Media Framework
inputproto                       InputProto - Input extension headers
opusfile                         opusfile - High-level Opus decoding library
ImageMagick++                    ImageMagick++ - Magick++ - C++ API for ImageMagick (ABI Q16)
libpng12                         libpng - Loads and saves PNG files
banshee-webbrowser               Banshee WebBrowser - Embedded web browser for the Banshee Media Framework
smbclient                        smbclient - A SMB library interface
xscrnsaver                       XScrnSaver - The XScrnSaver Library
shared-mime-info                 shared-mime-info - Freedesktop common MIME database
xcb-shm                          XCB Shm - XCB Shm Extension
protobuf                         Protocol Buffers - Google's Data Interchange Format
xcb                              XCB - X-protocol C Binding
mate-screensaver                 mate-screensaver - mate screensaver
libmpg123                        libmpg123 - An optimised MPEG Audio decoder
liblzma                          liblzma - General purpose data compression library
libswscale                       libswscale - FFmpeg image rescaling library
libavutil                        libavutil - FFmpeg utility library
ogg                              ogg - ogg is a library for manipulating ogg bitstreams
mono-lineeditor                  Mono.Terminal.LineEditor - Terminal text entry editor using System.Console.
yajl                             Yet Another JSON Library - A Portable JSON parsing and serialization library in ANSI C
libbluray                        libbluray - library supporting Blu-ray playback
libwebp                          libwebp - Library for the WebP graphics format
dbus-python                      dbus-python - Python bindings for D-Bus
fontconfig                       Fontconfig - Font configuration and customization library
mono                             Mono - Mono Runtime
cairo-xlib-xrender               cairo-xlib-xrender - Xlib Xrender surface backend for cairo graphics library
zziplib                          zziplib - ZZipLib - libZ-based ZIP-access Library with an Easy-to-Use API
banshee-nowplaying               Banshee NowPlaying - Now Playing extension source for Banshee
mono-nunit                       NUnit - Testing framework for CLI
avahi-client                     avahi-client - Avahi Multicast DNS Responder (Client Support)
harfbuzz-gobject                 harfbuzz - HarfBuzz text shaping library GObject integration
tslib-0.0                        tslib - Touchscreen Access Library
Qt5OpenGLExtensions              Qt5 OpenGLExtensions - Qt OpenGLExtensions module
zlib                             zlib - zlib compression library
python-3.4                       Python - Python library
SDL_image                        SDL_image - image loading library for Simple DirectMedia Layer
libnfs                           libnfs - libnfs is a client library for accessing NFS shares over a network.
OGRE-PCZ                         OGRE-PCZ - Portal-Connected Zone Scene Manager for OGRE
Qt5Widgets                       Qt5 Widgets - Qt Widgets module
com_err                          com_err - Common error description library
gobject-2.0                      GObject - GLib Type, Object, Parameter and Signal Library
Qt5Concurrent                    Qt5 Concurrent - Qt Concurrent module
mate-settings-daemon             mate-settings-daemon - Utility library for accessing mate-settings-daemon over DBUS
gio-2.0                          GIO - glib I/O library
libass                           libass - LibASS is an SSA/ASS subtitles rendering library
xdmcp                            Xdmcp - X Display Manager Control Protocol library
gtk+-x11-2.0                     GTK+ - GTK+ Graphical UI Library (x11 target)
libv4l1                          libv4l1 - v4l1 compatibility library
libv4l2                          libv4l2 - v4l2 device access library
libmicrohttpd                    libmicrohttpd - A library for creating an embedded HTTP server
xcb-xinerama                     XCB Xinerama - XCB Xinerama Extension
notify-python                    notify-python - Python bindings for libnotify
OGRE-Terrain                     OGRE-Terrain - Outdoor terrain component for OGRE
renderproto                      RenderProto - Render extension headers
